000033000011111111111111222222
033333300011111111111111122222
003333000011111111111111122222
000330000011111111111111122222
000000000111111111111111222222
000001111111111111111111111222
444444444444444444444444444444
444444444444444444444444444444
444444455555555555544444444444
444445555555555555555444444444
444455555555555555555544444444
444455555555555555555444444444
444445555555555555544444444444
444444555555555555544444444444
444444444444555444444444444444
444444444444444444444444444444
444444444444444444444444444444
444440000000000000000000000444
000000000000000000000000000000
000000000000000000000000000000
000020000200000222220000222000
222222022222022222222002222220
222222222222222222222222222222
222222222222222222222222222222
222111112221111122211111222111
221111111211111112111111121111
111111111111111111111111111111
111111111111111111111111111111
111111111111111111111111111111

